0 0 0 0 0 0 0 0 0 0 0 0 0 0 0 0 0 0 0
0 0 0 0 0 0 0 0 0 0 0 0 0 0 0 0 0 0 0
0 0 0 0 0 0 0 1 1 1 1 1 1 1 1 1 1 1 0
0 0 0 0 0 0 0 1 2 2 2 1 2 2 2 2 2 1 0
1 1 1 1 1 0 0 1 2 2 2 2 2 2 2 2 2 1 0
1 2 2 2 1 1 1 1 1 2 2 1 1 2 1 2 1 1 0
1 2 4 2 1 1 2 2 2 1 2 1 1 2 2 2 2 1 0
1 2 2 4 2 2 4 4 2 1 2 1 1 2 2 5 2 1 0
1 1 2 1 1 1 2 2 2 1 2 1 1 2 2 2 4 1 0
1 1 2 1 2 2 2 1 1 1 2 1 1 1 1 1 2 1 0
1 1 2 1 2 2 2 2 2 2 2 2 1 6 6 6 3 1 0
1 2 4 1 1 1 4 1 1 2 2 2 1 6 6 3 3 1 1
1 2 2 2 2 4 2 2 1 4 2 2 1 3 3 2 3 2 1
1 2 2 1 1 2 4 2 1 2 2 1 1 3 3 3 3 2 1
1 1 1 1 1 2 2 2 1 1 1 1 1 1 6 6 6 1 1
0 0 0 0 1 1 1 1 1 0 0 0 0 1 1 1 1 1 0
0 0 0 0 0 0 0 0 0 0 0 0 0 0 0 0 0 0 0
0 0 0 0 0 0 0 0 0 0 0 0 0 0 0 0 0 0 0
0 0 0 0 0 0 0 0 0 0 0 0 0 0 0 0 0 0 0
